111111111111111111
1CCCCCCCPCCCCCCCC1
1000000000000000C1
100000000000000001
10000000N000000001
000000000000000001
1C0000000000000001
1C0000000000000001
1CCCCCCCCCCCCCCCE1
111111111111111111