111111111111111111
10000000P000000001
100000000000000001
100000000000000001
10000000N000000001
100000000000000001
100000000000000001
100000000000000001
1000000000000000E1
111111111111111111