11111111111111111111111111
1CCCCCCCPCCCCCCCCCCCCCCCC1
100000000000000000000000C1
1CCCCCCCCCCCCCCCCCCCCCCCC1
1C000000000000000000000001
1C0000000000N0000000000001
1C000000000000000000000001
1C000000000000000000000001
1CCCCCCCCCCCCCCCCCCCCCCCE1
11111111111111111111111111